XXXXXXXXXXXXXXXXXXXXXXXXXXXXXXXXXXXX
X                    X            SX
X XXXX XXXXXX XXXXX XXXXX XXXXXXXX X
X XX   X   X      X        XX      X
X XX X X X X XXXX XXXXXXXXX X XXXXXX
X XX X X X X             XX        X
X XX X X X X X XXXX  XXX    XXXXXX X
X X  X X X   X    XX XXXX XXX      X
X XX X X XXX XXXX XX        XX XXXXX
X XX X   XX       XXXX XXXX XX     X
X    XXXXXX XXXXXXX      XX XXXXXX X
XXXXXX      X       XXXX XX X      X
X      XXXXXX XXXXX X    XX XX XXXXX
X XXXXXX      X       XXXXX XX     X
X        XXXXXX XXXXXXXXXXX XX  XX X
XXXXXXXXXX                  XXXXXX X
XG         XXXXXXXXXXXXXXXX        X
XXXXXXXXXXXXXXXXXXXXXXXXXXXXXXXXXXXX

